....................
#......#...#...#....
.....#.....#.....#..
##......#.....#.....
.......#.....#......
....................
......#....#..#.....
...#.....#......#...
........#....#......
..........#....#....
#....#.....#........
............#....#..
....#......#........
#.......#........#..
###....#.###........
..#......#....#.....
#...#...#..#........
....................