....................
.#.....#...#...#....
.....#.....#.....#..
.##.....#.....#.....
.......#.....#......
....................
......#....#..#.....
...#.....#......#...
........#....#......
..........#....#....
.#...#.....#........
............#....#..
....#......#........
.#......#........#..
.###...#.###........
..#......#....#.....
.#..#...#..#........
....................