....................
........##.#........
..............###...
.............#......
.##..#.........#....
...#..#........#....
..#............#....
........#...........
....##.#......#.#...
....#....#...###....
.................#..
..#.#.........#.....
.#......##.#.#......
.....###....#...#...
.#.#....#...........
.#......#...#.......
....................
....................