....................
.##....#............
................#.#.
......#....#...#....
......#......#......
........#..#......#.
.##........#........
...#....#...#.......
.#.#..#.............
...#...........#....
.....#.......#....#.
.##...#.............
.....#....#...#.....
.....#..........##..
....#.....#....#....
...#......#.#.......
..#...#.....#.......
....................