....................
................#...
...##..........#....
.#...#.#............
............#..#....
....................
.................#..
.#..#..#............
...........#.....#..
.......#........#...
......#......#......
...##.......#.......
.#...........#......
.#................#.
...#..##............
..........###.......
.......#.....##.....
....................