....................
............#.##....
.............#......
......#.....#.......
.....#.#.........#..
..#.#........#......
.........##.#.......
.#.......##.........
..............#.....
........#...#..#....
..#.##..............
.................#..
...#........##......
....#..........#..#.
......##......#.....
.#.......#...#......
..#.......#.........
....................